1111111111111111111111111111111111111111111111111111111111111111111111111111111111111111111111111111
1111111111111111111111111111111111111111111111111111111111111111111111111111111111111111111111111111
11                                                                                                11
11                                                                                                11
11                                                                                                11
11                                                                                                11
11                                                                ---                             11
11                                                                -P-                             11
11                                                                ---                             11
11                                                                                                11
11                                                                                                11
11                        1-------------------1--------111111111                                  11
11                        11111111111111111111---------111111111                                  11
11                                                            11                                  11
11                                                            11                                  11
11                                                            11                                  11
11                                                            11                                  11
11                ---                                         11                                  11
11                -B-                                         11                                  11
11                ---                                         11                                  11
11                                                            11                                  11
11                                                            11                                  11
11                                                            11                                  11
11                                                            11                                  11
11                                                            11                                  11
11                                                            11                                  11
11                                1111                                                            11
11                                1111                                                            11
11                                1111                                                            WW
11                                1111                                                            WW
WW                                1111                                                            WW
WW                                1111                                                            WW
WW                                1111                                                            WW
WW                                1111                                                            WW
WW                                1111                                                            WW
WW                                1111                                                            11
WW                                1111                                                            11
WW                                1111                                                            11
11                                111111111111111111111111111111111111111111111111111             11
11                                111111111111111111111111111111111111111111111111111             11
11                                                          11                                    11
11                                                          11                                    11
11                                                          11                                    11
11                                                          11                                    11
11                                                          11                                    11
11                                                          11                                    11
11                                                          11                                    11
11                                                          11                                    11
11                                                          11                                    11
11                                                          11                                    11
11                                                          11                                    11
11                                                          11                                    11
11                                                          11                                    11
11                                                          11                                    11
11                                                          11                                    11
11                                                          11                                    11
11                                                          11                                    11
11                                                          11                                    11
11               111111111111111111111111111111111111111111111                                    11
11               111111111111111111111111111111111111111111111                                    11
11                                                          11                                    11
11                                                          11                                    11
11                                                          11                                    11
11                                                          11                                    11
11                                                          11                                    11
11                                                          11                                    11
11                                                          11                                    11
11                                                          11                                    11
11                                                          11                                    11
11                                                                                                11
11                                                                                                11
11                                                                                                11
11                                                                                                11
11                                                                                                11
11                                                                                                11
11                                                                                                11
11                                                                                                11
11                                                                                                11
11                                                                                                11
11                                                                                                11
11                                                                                                11
11                                                                                                11
11                                                                                                11
11                                                                                                11
11                                                                                                11
11                         11111111111111111111111111111111111111111111111111111111111            11
11                         11111111111111111111111111111111111111111111111111111111111            11
11                                                                                                11
11                                                                                                11
11                                                                                                11
11                                                                                                11
11                                                                                                11
11                                                                                                11
11                                                                                                11
11                                                                                                11
11                                                                                                11
11                                                                                                11
11                                                                                                11
1111111111111111111111111111111111111111111111111111111111111111111111111111111111111111111111111111
1111111111111111111111111111111111111111111111111111111111111111111111111111111111111111111111111111
