1111111111111111111111111111111111111111111111111111111111111111111111111111111111111111111111111111
1111111111111111111111111111111111111111111111111111111111111111111111111111111111111111111111111111
11                                                                                                11
11                                                                                                11
11                                                                                                11
11                                                                                                11
11                                                                                                11
11                                                                                                11
11                                                                                                11
11                                                                                                11
11                                                                                                11
11                        11111111111111111111111111111111111111                                  11
11                        11111111111111111111111111111111111111                                  11
11                                                            11                                  11
11                                                            11                                  11
11                                                            11                                  11
11                                                            11                                  11
11                                                            11                                  11
11                                                            11                                  11
11                                                            11                                  11
11                                                            11                                  11
11                                                            11                                  11
11                                                            11                                  11
11                                                            11                                  11
11                                                            11                                  11
11                                                            11                                  11
11                                1111                                                            11
11                                1111                                                            11
11                                1111                                                            11
11                                1111                                                            11
11                                1111                                                            11
11                                1111                                                            11
11                                1111                                                            11
11                                1111                                                            11
11                                1111                                                            11
11                                1111                                                            11
11                                1111                                                            11
11                                1111                                                            11
11                                111111111111111111111111111111111111111111111111111             11
11                                111111111111111111111111111111111111111111111111111             11
11                                                          11                                    11
11                                                          11                                    11
11                                                          11                                    11
11                                                          11                                    11
11                                                          11                                    11
11                                                          11                                    11
11                                                          11                                    11
11                                                          11                                    11
11                                                          11                                    11
11                                                          11                                    11
11                                                          11                                    11
11                                                          11                                    11
11                                                          11                                    11
11                                                          11                                    11
11                                                          11                                    11
11                                                          11                                    11
11                                                          11                                    11
11                                                          11                                    11
11               11111111111111111111111111111111111111111111111111111111111                      11
11               11111111111111111111111111111111111111111111111111111111111                      11
11                                                          11                                    11
11                                                          11                                    11
11                                                          11                                    11
11                                                          11                                    11
11                                                          11                                    11
11                                                          11                                    11
11                                                          11                                    11
11                                                          11                                    11
11                                                          11                                    11
11                                                                                                11
11                                                                                                11
11                                                                                                11
11                                                                                                11
11                                                                                                11
11                                                                                                11
11                                                                                                11
11                                                                                                11
11                                                                                                11
11                                                                                                11
11                                                                                                11
11                                                                                                11
11                                                                                                11
11                                                                                                11
11                                                                                                11
11                                                                                                11
11                         11111111111111111111111111111111111111111111111111111111111            11
11                         11111111111111111111111111111111111111111111111111111111111            11
11                                                                                                11
11                                                                                                11
11                                                                                                11
11                                                                                                11
11                                                                                                11
11                                                                                                11
11                                                                                                11
11                                                                                                11
11                                                                                                11
11                                                                                                11
11                                                                                                11
1111111111111111111111111111111111111111111111111111111111111111111111111111111111111111111111111111
1111111111111111111111111111111111111111111111111111111111111111111111111111111111111111111111111111
